680 , 680 , 680 , 680 , 680 , 680 , 680 , 680 , 680 , 680 , 680 , 680 , 680 , 680 , 680 , 680 , 680 , 680 , 680 , 680 , 680 , 680 , 680 , 680 , 694 , 695 , 696 , 697 , 698 , 699 , 810 , 811 , 812 , 813 , 814 , 815 , 816 , 817 , 818 , 819 , 680 , 680 , 680 , 680 , 680 , 680 , 680 , 680 , 680 , 680 , 680 , 680 , 680 , 680 , 680 , 690 , 691 , 692 , 693 , 694 , 695 , 696 , 697 , 698 , 699 , 810 , 811 , 812 , 813 , 814 , 815 , 816 , 817 , 818 , 819 , 680 , 680 , 680 , 680 , 680 , 680 , 680 , 680 , 680 , 680 , 680 , 680 , 680 , 680 , 680 , 680 , 680 , 680 , 680 , 680 , 680 , 680 , 680 , 680 , 680 ,
680 , 680 , 680 , 680 , 680 , 680 , 680 , 680 , 680 , 680 , 680 , 680 , 680 , 680 , 680 , 680 , 680 , 680 , 680 , 680 , 680 , 680 , 680 , 680 , 704 , 705 , 706 , 707 , 708 , 709 , 820 , 821 , 822 , 823 , 824 , 825 , 826 , 827 , 828 , 829 , 680 , 680 , 680 , 680 , 680 , 680 , 680 , 680 , 680 , 680 , 680 , 680 , 680 , 680 , 680 , 700 , 701 , 702 , 703 , 704 , 705 , 706 , 707 , 708 , 709 , 820 , 821 , 822 , 823 , 824 , 825 , 826 , 827 , 828 , 829 , 680 , 680 , 680 , 680 , 680 , 680 , 680 , 680 , 680 , 680 , 680 , 680 , 680 , 680 , 680 , 680 , 680 , 680 , 680 , 680 , 680 , 680 , 680 , 680 , 680 ,
680 , 680 , 680 , 680 , 680 , 680 , 680 , 680 , 680 , 680 , 680 , 680 , 680 , 680 , 680 , 680 , 680 , 680 , 680 , 680 , 680 , 680 , 680 , 680 , 714 , 715 , 716 , 717 , 718 , 719 , 830 , 831 , 832 , 833 , 834 , 835 , 836 , 837 , 838 , 839 , 680 , 680 , 680 , 680 , 680 , 680 , 680 , 680 , 680 , 680 , 680 , 680 , 680 , 680 , 693 , 694 , 695 , 696 , 697 , 698 , 715 , 716 , 717 , 718 , 719 , 830 , 831 , 832 , 833 , 834 , 835 , 836 , 837 , 838 , 839 , 14 , 14 , 14 , 14 , 14 , 14 , 14 , 14 , 14 , 14 , 14 , 14 , 14 , 14 , 14 , 14 , 14 , 14 , 14 , 14 , 14 , 14 , 14 , 14 , 14 ,
680 , 680 , 680 , 680 , 680 , 680 , 680 , 680 , 680 , 680 , 680 , 680 , 680 , 680 , 680 , 680 , 680 , 680 , 680 , 680 , 680 , 680 , 680 , 680 , 724 , 725 , 726 , 727 , 728 , 729 , 840 , 841 , 842 , 843 , 844 , 845 , 846 , 847 , 822 , 823 , 845 , 846 , 847 , 848 , 849 , 14 , 14 , 14 , 14 , 14 , 14 , 14 , 14 , 14 , 703 , 704 , 705 , 706 , 707 , 708 , 725 , 726 , 727 , 728 , 729 , 840 , 841 , 842 , 843 , 844 , 845 , 846 , 847 , 848 , 849 , 14 , 14 , 14 , 14 , 14 , 14 , 14 , 14 , 14 , 14 , 14 , 14 , 14 , 14 , 14 , 14 , 14 , 14 , 14 , 14 , 14 , 14 , 14 , 14 , 14 ,
690 , 691 , 692 , 693 , 694 , 695 , 696 , 697 , 698 , 699 , 810 , 811 , 812 , 813 , 814 , 815 , 816 , 817 , 818 , 819 , 730 , 731 , 732 , 733 , 734 , 735 , 736 , 737 , 738 , 739 , 850 , 851 , 852 , 853 , 854 , 855 , 856 , 857 , 832 , 833 , 855 , 856 , 857 , 858 , 859 , 693 , 694 , 695 , 696 , 697 , 698 , 699 , 810 , 811 , 713 , 714 , 715 , 716 , 717 , 718 , 735 , 736 , 737 , 738 , 739 , 850 , 851 , 852 , 853 , 854 , 855 , 856 , 857 , 858 , 859 , 14 , 14 , 14 , 14 , 14 , 14 , 14 , 14 , 14 , 14 , 14 , 14 , 14 , 14 , 14 , 14 , 14 , 14 , 14 , 14 , 14 , 14 , 14 , 14 , 14 , 
700 , 701 , 702 , 703 , 704 , 705 , 706 , 707 , 708 , 709 , 820 , 821 , 822 , 823 , 824 , 825 , 826 , 696 , 697 , 698 , 699 , 741 , 742 , 743 , 744 , 745 , 746 , 747 , 748 , 749 , 860 , 861 , 862 , 863 , 864 , 865 , 866 , 867 , 842 , 843 , 865 , 866 , 867 , 868 , 869 , 703 , 704 , 705 , 706 , 707 , 708 , 709 , 820 , 821 , 723 , 724 , 725 , 726 , 727 , 728 , 745 , 746 , 747 , 748 , 749 , 860 , 861 , 862 , 863 , 864 , 865 , 866 , 867 , 868 , 869 , -1 , 811 , 812 , 813 , 814 , 815 , 816 , 817 , 818 , 14 , 14 , 14 , 14 , 14 , 14 , 821 , 822 , 823 , 824 , 825 , 826 , 827 , 828 , 829 , 14 ,
710 , 711 , 712 , 713 , 714 , 715 , 716 , 717 , 718 , 719 , 830 , 831 , 832 , 833 , 834 , 835 , 836 , 706 , 707 , 708 , 709 , 751 , 752 , 753 , 754 , 755 , 756 , 757 , 758 , 759 , 870 , 871 , 872 , 873 , 874 , 875 , 876 , 877 , 878 , 744 , 875 , 876 , 877 , 833 , 834 , 835 , 836 , 715 , 716 , 717 , 718 , 719 , 830 , 831 , 733 , 734 , 735 , 736 , 737 , 738 , 755 , 756 , 757 , 758 , 759 , 870 , 871 , 872 , 873 , 874 , 875 , 876 , 877 , 878 , 879 , -1 , 821 , 822 , 823 , 824 , 825 , 826 , 827 , 828 , 710 , 711 , 712 , 713 , 714 , 715 , 831 , 832 , 833 , 834 , 835 , 836 , 837 , 838 , 839 , 14 ,
720 , 721 , 722 , 723 , 724 , 725 , 726 , 727 , 728 , 729 , 840 , 841 , 842 , 843 , 844 , 845 , 846 , 716 , 717 , 718 , 719 , 761 , 762 , 763 , 764 , 765 , 766 , 767 , 768 , 769 , 880 , 881 , 882 , 883 , 884 , 771 , 772 , 773 , 774 , 775 , 776 , 777 , 753 , 843 , 844 , 845 , 846 , 725 , 726 , 727 , 728 , 729 , 840 , 841 , 842 , 760 , 761 , 762 , 763 , 764 , 765 , 766 , 767 , 768 , 769 , 880 , 881 , 882 , 883 , 884 , 885 , 886 , 887 , 888 , 889 , 830 , 831 , 832 , 833 , 834 , 835 , 836 , 837 , 838 , 720 , 721 , 722 , 723 , 724 , 725 , 841 , 842 , 843 , 844 , 845 , 846 , 847 , 848 , 849 , 14 ,
730 , 731 , 732 , 733 , 734 , 735 , 736 , 737 , 738 , 739 , 850 , 851 , 852 , 853 , 854 , 855 , 856 , 726 , 727 , 728 , 729 , 771 , 772 , 773 , 774 , 775 , 776 , 777 , 778 , 779 , 770 , 771 , 772 , 773 , 774 , 781 , 782 , 783 , 784 , 785 , 786 , 787 , 744 , 853 , 854 , 855 , 856 , 735 , 736 , 737 , 738 , 739 , 850 , 851 , 852 , 770 , 771 , 772 , 773 , 774 , 775 , 776 , 777 , 778 , 779 , 770 , 771 , 772 , 773 , 774 , 775 , 776 , 777 , 778 , 779 , 840 , 841 , 842 , 843 , 844 , 845 , 846 , 847 , 848 , 730 , 731 , 732 , 733 , 734 , 735 , 851 , 852 , 853 , 854 , 855 , 856 , 857 , 845 , 846 , 847 ,
740 , 741 , 742 , 743 , 744 , 745 , 746 , 747 , 748 , 749 , 860 , 861 , 862 , 863 , 864 , 865 , 866 , 736 , 737 , 738 , 739 , 781 , 782 , 783 , 784 , 785 , 786 , 787 , 788 , 789 , 780 , 781 , 782 , 783 , 784 , 791 , 792 , 793 , 794 , 795 , 796 , 797 , 744 , 863 , 864 , 865 , 866 , 745 , 746 , 747 , 748 , 749 , 860 , 861 , 862 , 780 , 781 , 782 , 783 , 784 , 785 , 786 , 787 , 788 , 789 , 780 , 781 , 782 , 783 , 784 , 785 , 786 , 787 , 788 , 789 , 850 , 851 , 852 , 853 , 854 , 855 , 856 , 857 , 858 , 740 , 741 , 742 , 743 , 744 , 745 , 861 , 862 , 863 , 864 , 865 , 866 , 867 , 855 , 856 , 857 ,
750 , 751 , 752 , 753 , 754 , 755 , 756 , 757 , 758 , 759 , 870 , 871 , 872 , 873 , 874 , 875 , 876 , 746 , 747 , 748 , 749 , 791 , 792 , 793 , 794 , 795 , 796 , 797 , 798 , 799 , 790 , 791 , 792 , 793 , 794 , 771 , 772 , 773 , 774 , 775 , 776 , 777 , 753 , 753 , 753 , 753 , 754 , 755 , 756 , 757 , 758 , 759 , 870 , 871 , 872 , 790 , 791 , 792 , 793 , 794 , 795 , 796 , 797 , 798 , 799 , 790 , 791 , 792 , 793 , 794 , 795 , 796 , 797 , 798 , 799 , 860 , 861 , 862 , 863 , 864 , 865 , 866 , 867 , 868 , 750 , 751 , 752 , 753 , 754 , 755 , 871 , 872 , 873 , 874 , 875 , 876 , 877 , 878 , 883 , 884 ,
760 , 761 , 762 , 763 , 764 , 765 , 766 , 767 , 768 , 769 , 880 , 881 , 882 , 883 , 884 , 885 , 886 , 756 , 757 , 758 , 759 , 801 , 802 , 803 , 804 , 805 , 806 , 807 , 808 , 809 , 800 , 801 , 802 , 803 , 804 , 781 , 782 , 783 , 784 , 785 , 786 , 787 , 760 , 753 , 762 , 763 , 764 , 765 , 766 , 767 , 768 , 769 , 880 , 881 , 882 , 800 , 801 , 802 , 803 , 804 , 805 , 806 , 807 , 808 , 809 , 800 , 801 , 802 , 803 , 804 , 805 , 806 , 807 , 808 , 809 , 870 , 871 , 872 , 873 , 874 , 875 , 876 , 877 , 878 , 746 , 747 , 748 , 749 , 860 , 861 , 881 , 882 , 883 , 884 , 885 , 886 , 887 , 888 , 893 , 894 ,
770 , 771 , 772 , 773 , 774 , 775 , 776 , 777 , 778 , 779 , 770 , 771 , 772 , 773 , 774 , 775 , 776 , 777 , 778 , 779 , 770 , 771 , 772 , 773 , 774 , 775 , 776 , 777 , 778 , 779 , 770 , 771 , 772 , 773 , 774 , 791 , 792 , 793 , 794 , 795 , 796 , 797 , 770 , 771 , 772 , 773 , 774 , 775 , 776 , 777 , 778 , 779 , 770 , 771 , 772 , 770 , 771 , 772 , 773 , 774 , 775 , 776 , 777 , 778 , 779 , 770 , 771 , 772 , 773 , 774 , 775 , 776 , 777 , 778 , 779 , 880 , 881 , 882 , 883 , 884 , 885 , 886 , 887 , 888 , 756 , 757 , 758 , 759 , 870 , 871 , 872 , 873 , 874 , 875 , 876 , 877 , 878 , 883 , 884 , 885 ,
780 , 781 , 782 , 783 , 784 , 785 , 786 , 787 , 788 , 789 , 780 , 781 , 782 , 783 , 784 , 785 , 786 , 787 , 788 , 789 , 780 , 781 , 782 , 783 , 784 , 785 , 786 , 787 , 788 , 789 , 780 , 781 , 782 , 783 , 784 , 785 , 771 , 772 , 773 , 774 , 775 , 776 , 777 , 781 , 782 , 783 , 784 , 785 , 786 , 787 , 788 , 789 , 780 , 781 , 782 , 780 , 781 , 782 , 783 , 784 , 785 , 786 , 787 , 788 , 789 , 780 , 781 , 782 , 783 , 784 , 785 , 786 , 787 , 763 , 764 , 765 , 766 , 767 , 768 , 769 , 762 , 763 , 764 , 765 , 766 , 767 , 768 , 769 , 880 , 881 , 882 , 883 , 884 , 885 , 886 , 887 , 888 , 893 , 894 , 895 ,
790 , 791 , 792 , 793 , 794 , 795 , 796 , 797 , 798 , 799 , 790 , 791 , 792 , 793 , 794 , 795 , 796 , 797 , 798 , 799 , 790 , 791 , 792 , 793 , 794 , 795 , 796 , 797 , 798 , 799 , 770 , 771 , 772 , 773 , 774 , 775 , 781 , 782 , 783 , 784 , 785 , 786 , 787 , 791 , 792 , 793 , 794 , 795 , 796 , 797 , 798 , 799 , 790 , 791 , 792 , 790 , 791 , 792 , 793 , 794 , 795 , 796 , 797 , 798 , 799 , 770 , 771 , 772 , 773 , 774 , 775 , 776 , 777 , 773 , 774 , 775 , 776 , 777 , 778 , 779 , 772 , 773 , 774 , 775 , 776 , 777 , 778 , 779 , 770 , 771 , 772 , 773 , 774 , 775 , 776 , 777 , 778 , 903 , 904 , 905 ,
800 , 801 , 802 , 803 , 804 , 805 , 806 , 807 , 808 , 809 , 800 , 801 , 802 , 803 , 804 , 805 , 806 , 807 , 808 , 809 , 770 , 771 , 772 , 773 , 774 , 775 , 776 , 777 , 778 , 779 , 780 , 781 , 782 , 783 , 784 , 785 , 791 , 792 , 771 , 772 , 773 , 774 , 775 , 776 , 777 , 803 , 804 , 805 , 806 , 807 , 808 , 809 , 800 , 801 , 802 , 770 , 771 , 772 , 773 , 774 , 775 , 776 , 777 , 778 , 779 , 780 , 781 , 782 , 783 , 784 , 785 , 786 , 787 , 783 , 784 , 785 , 786 , 787 , 788 , 789 , 782 , 783 , 784 , 785 , 786 , 787 , 788 , 789 , 780 , 781 , 782 , 783 , 784 , 785 , 786 , 787 , 788 , 789 , 793 , 794 ,
770 , 771 , 772 , 773 , 774 , 775 , 776 , 777 , 778 , 779 , 770 , 771 , 772 , 773 , 774 , 775 , 776 , 777 , 778 , 779 , 780 , 781 , 782 , 783 , 784 , 785 , 786 , 787 , 788 , 789 , 790 , 791 , 792 , 793 , 794 , 795 , 796 , 797 , 781 , 782 , 783 , 784 , 785 , 786 , 787 , 773 , 774 , 775 , 776 , 777 , 778 , 779 , 770 , 771 , 772 , 780 , 781 , 782 , 783 , 784 , 785 , 786 , 787 , 788 , 789 , 790 , 791 , 792 , 793 , 794 , 795 , 796 , 797 , 793 , 794 , 795 , 796 , 797 , 798 , 799 , 792 , 793 , 794 , 795 , 796 , 797 , 798 , 799 , 790 , 791 , 792 , 793 , 794 , 795 , 796 , 797 , 798 , 799 , 764 , 764 ,
-1 , -1 , -1 , -1 , -1 , -1 , -1 , -1 , -1 , -1 , -1 , -1 , -1 , -1 , -1 , -1 , -1 , -1 , -1 , -1 , -1 , -1 , -1 , -1 , -1 , -1 , -1 , -1 , -1 , -1 , -1 , -1 , -1 , -1 , -1 , -1 , -1 , -1 , -1 , -1 , -1 , -1 , -1 , -1 , -1 , -1 , -1 , -1 , -1 , -1 , -1 , -1 , -1 , -1 , -1 , -1 , -1 , -1 , -1 , -1 , -1 , -1 , -1 , -1 , -1 , -1 , -1 , -1 , -1 , -1 , -1 , -1 , -1 , -1 , -1 , -1 , -1 , -1 , -1 , -1 , -1 , -1 , -1 , -1 , -1 , -1 , -1 , -1 , -1 , -1 , -1 , -1 , -1 , -1 , -1 , -1 , -1 , -1 , -1 , -1 ,
-1 , -1 , -1 , -1 , -1 , -1 , -1 , -1 , -1 , -1 , -1 , -1 , -1 , -1 , -1 , -1 , -1 , -1 , -1 , -1 , -1 , -1 , -1 , -1 , -1 , -1 , -1 , -1 , -1 , -1 , -1 , -1 , -1 , -1 , -1 , -1 , -1 , -1 , -1 , -1 , -1 , -1 , -1 , -1 , -1 , -1 , -1 , -1 , -1 , -1 , -1 , -1 , -1 , -1 , -1 , -1 , -1 , -1 , -1 , -1 , -1 , -1 , -1 , -1 , -1 , -1 , -1 , -1 , -1 , -1 , -1 , -1 , -1 , -1 , -1 , -1 , -1 , -1 , -1 , -1 , -1 , -1 , -1 , -1 , -1 , -1 , -1 , -1 , -1 , -1 , -1 , -1 , -1 , -1 , -1 , -1 , -1 , -1 , -1 , -1 ,
-1 , -1 , -1 , -1 , -1 , -1 , -1 , -1 , -1 , -1 , -1 , -1 , -1 , -1 , -1 , -1 , -1 , -1 , -1 , -1 , -1 , -1 , -1 , -1 , -1 , -1 , -1 , -1 , -1 , -1 , -1 , -1 , -1 , -1 , -1 , -1 , -1 , -1 , -1 , -1 , -1 , -1 , -1 , -1 , -1 , -1 , -1 , -1 , -1 , -1 , -1 , -1 , -1 , -1 , -1 , -1 , -1 , -1 , -1 , -1 , -1 , -1 , -1 , -1 , -1 , -1 , -1 , -1 , -1 , -1 , -1 , -1 , -1 , -1 , -1 , -1 , -1 , -1 , -1 , -1 , -1 , -1 , -1 , -1 , -1 , -1 , -1 , -1 , -1 , -1 , -1 , -1 , -1 , -1 , -1 , -1 , -1 , -1 , -1 , -1 ,
-1 , -1 , -1 , -1 , -1 , -1 , -1 , -1 , -1 , -1 , -1 , -1 , -1 , -1 , -1 , -1 , -1 , -1 , -1 , -1 , -1 , -1 , -1 , -1 , -1 , -1 , -1 , -1 , -1 , -1 , -1 , -1 , -1 , -1 , -1 , -1 , -1 , -1 , -1 , -1 , -1 , -1 , -1 , -1 , -1 , -1 , -1 , -1 , -1 , -1 , -1 , -1 , -1 , -1 , -1 , -1 , -1 , -1 , -1 , -1 , -1 , -1 , -1 , -1 , -1 , -1 , -1 , -1 , -1 , -1 , -1 , -1 , -1 , -1 , -1 , -1 , -1 , -1 , -1 , -1 , -1 , -1 , -1 , -1 , -1 , -1 , -1 , -1 , -1 , -1 , -1 , -1 , -1 , -1 , -1 , -1 , -1 , -1 , -1 , -1 ,
-1 , -1 , -1 , -1 , -1 , -1 , -1 , -1 , -1 , -1 , -1 , -1 , -1 , -1 , -1 , -1 , -1 , -1 , -1 , -1 , -1 , -1 , -1 , -1 , -1 , -1 , -1 , -1 , -1 , -1 , -1 , -1 , -1 , -1 , -1 , -1 , -1 , -1 , -1 , -1 , -1 , -1 , -1 , -1 , -1 , -1 , -1 , -1 , -1 , -1 , -1 , -1 , -1 , -1 , -1 , -1 , -1 , -1 , -1 , -1 , -1 , -1 , -1 , -1 , -1 , -1 , -1 , -1 , -1 , -1 , -1 , -1 , -1 , -1 , -1 , -1 , -1 , -1 , -1 , -1 , -1 , -1 , -1 , -1 , -1 , -1 , -1 , -1 , -1 , -1 , -1 , -1 , -1 , -1 , -1 , -1 , -1 , -1 , -1 , -1 ,
