560 , 570 , 570 , 580 , 560 , 560 , 561 , 562 , 563 , 564 , 565 , 566 , 560 , 560 , 560 , 560 , 560 , 560 , 560 , 560 , 560 , 560 , 560 , 560 , 560 , 560 , 560 , 560 , 560 , 560 , 560 , 560 , 560 , 560 , 560 , 560 , 560 , 560 , 560 , 560 , 560 , 560 , 560 , 560 , 560 , 560 , 560 , 560 , 560 , 560 , 560 , 560 , 560 , 560 , 560 , 560 , 560 , 560 , 560 , 560 , 560 , 560 , 560 , 560 , 560 , 560 , 560 , 560 , 560 , 560 , 560 , 560 , 560 , 560 , 560 , 560 , 560 , 560 , 560 , 560 , 560 , 560 , 560 , 560 , 560 , 560 , 560 , 560 , 560 , 560 , 560 , 560 , 560 , 560 , 560 , 560 , 560 , 560 , 560 , 560 , 
570 , 580 , 580 , 590 , 570 , 560 , 561 , 562 , 563 , 564 , 565 , 566 , 570 , 570 , 570 , 570 , 570 , 570 , 570 , 570 , 570 , 570 , 570 , 570 , 570 , 570 , 570 , 570 , 570 , 570 , 570 , 570 , 570 , 570 , 570 , 570 , 570 , 570 , 570 , 570 , 570 , 570 , 570 , 570 , 570 , 570 , 570 , 570 , 570 , 570 , 570 , 570 , 570 , 570 , 570 , 570 , 570 , 570 , 570 , 570 , 570 , 570 , 570 , 570 , 570 , 570 , 570 , 570 , 570 , 570 , 570 , 570 , 570 , 570 , 570 , 570 , 570 , 570 , 570 , 570 , 570 , 570 , 570 , 570 , 570 , 570 , 570 , 570 , 570 , 570 , 570 , 570 , 570 , 570 , 570 , 570 , 570 , 570 , 570 , 570 , 
580 , 590 , 590 , 590 , 580 , 560 , 561 , 562 , 563 , 564 , 565 , 566 , 580 , 580 , 580 , 580 , 580 , 580 , 580 , 580 , 580 , 580 , 580 , 580 , 580 , 580 , 580 , 580 , 580 , 580 , 580 , 580 , 580 , 580 , 580 , 580 , 580 , 580 , 580 , 580 , 580 , 580 , 580 , 580 , 580 , 580 , 580 , 580 , 580 , 580 , 580 , 580 , 580 , 580 , 580 , 580 , 580 , 580 , 580 , 580 , 580 , 580 , 580 , 580 , 580 , 580 , 580 , 580 , 580 , 580 , 580 , 580 , 580 , 580 , 580 , 580 , 580 , 580 , 580 , 580 , 580 , 580 , 580 , 580 , 580 , 580 , 580 , 580 , 580 , 580 , 580 , 580 , 580 , 580 , 580 , 580 , 580 , 580 , 580 , 580 , 
590 , 590 , 591 , 592 , 590 , 560 , 561 , 562 , 563 , 564 , 565 , 566 , 590 , 590 , 590 , 590 , 590 , 590 , 590 , 590 , 590 , 590 , 590 , 590 , 590 , 590 , 590 , 590 , 590 , 590 , 590 , 590 , 590 , 590 , 590 , 590 , 590 , 590 , 590 , 590 , 590 , 590 , 590 , 590 , 590 , 590 , 590 , 590 , 590 , 590 , 590 , 590 , 590 , 590 , 590 , 590 , 590 , 590 , 590 , 590 , 590 , 590 , 590 , 590 , 590 , 590 , 590 , 590 , 590 , 590 , 590 , 590 , 590 , 590 , 590 , 590 , 590 , 590 , 590 , 590 , 590 , 590 , 590 , 590 , 590 , 590 , 590 , 590 , 590 , 590 , 590 , 590 , 590 , 590 , 590 , 590 , 590 , 590 , 590 , 590 , 
590 , 591 , 592 , 593 , 594 , 560 , 561 , 562 , 563 , 564 , 565 , 566 , 590 , 590 , 590 , 590 , 590 , 590 , 590 , 590 , 590 , 590 , 590 , 590 , 590 , 590 , 590 , 590 , 590 , 590 , 590 , 590 , 590 , 590 , 590 , 590 , 590 , 590 , 590 , 590 , 590 , 590 , 590 , 590 , 590 , 590 , 590 , 590 , 590 , 590 , 590 , 590 , 590 , 590 , 590 , 590 , 590 , 590 , 590 , 590 , 590 , 590 , 590 , 590 , 590 , 590 , 590 , 590 , 590 , 590 , 590 , 590 , 590 , 590 , 590 , 590 , 590 , 590 , 590 , 590 , 590 , 590 , 590 , 590 , 590 , 590 , 590 , 590 , 590 , 590 , 590 , 590 , 590 , 590 , 590 , 590 , 590 , 590 , 590 , 590 , 
590 , 591 , 592 , 593 , 594 , 560 , 561 , 562 , 563 , 564 , 565 , 566 , 590 , 590 , 590 , 590 , 590 , 590 , 590 , 590 , 590 , 590 , 590 , 590 , 590 , 590 , 590 , 590 , 590 , 590 , 590 , 590 , 590 , 590 , 590 , 590 , 590 , 590 , 590 , 590 , 590 , 590 , 590 , 590 , 590 , 590 , 590 , 590 , 590 , 590 , 590 , 590 , 590 , 590 , 590 , 590 , 590 , 590 , 590 , 590 , 590 , 590 , 590 , 590 , 590 , 590 , 590 , 590 , 590 , 590 , 590 , 590 , 590 , 590 , 590 , 590 , 590 , 590 , 590 , 590 , 590 , 590 , 590 , 590 , 590 , 590 , 590 , 590 , 590 , 590 , 590 , 590 , 590 , 590 , 590 , 590 , 590 , 590 , 590 , 590 , 
590 , 591 , 592 , 593 , 594 , 560 , 561 , 562 , 563 , 564 , 565 , 566 , 590 , 590 , 590 , 590 , 590 , 590 , 590 , 590 , 590 , 590 , 590 , 590 , 590 , 590 , 590 , 590 , 590 , 590 , 590 , 590 , 590 , 590 , 590 , 590 , 590 , 590 , 590 , 590 , 590 , 590 , 590 , 590 , 590 , 590 , 590 , 590 , 590 , 590 , 590 , 590 , 590 , 590 , 590 , 590 , 590 , 590 , 590 , 590 , 590 , 590 , 590 , 590 , 590 , 590 , 590 , 590 , 590 , 590 , 590 , 590 , 590 , 590 , 590 , 590 , 590 , 590 , 590 , 590 , 590 , 590 , 590 , 590 , 590 , 590 , 590 , 590 , 590 , 590 , 590 , 590 , 590 , 590 , 590 , 590 , 590 , 590 , 590 , 590 , 
590 , 591 , 592 , 593 , 594 , 560 , 560 , 561 , 562 , 563 , 564 , 565 , 590 , 590 , 590 , 590 , 590 , 590 , 590 , 590 , 590 , 590 , 590 , 590 , 590 , 590 , 590 , 590 , 590 , 590 , 590 , 590 , 590 , 590 , 590 , 590 , 590 , 590 , 590 , 590 , 590 , 590 , 590 , 590 , 590 , 590 , 590 , 590 , 590 , 590 , 590 , 590 , 590 , 590 , 590 , 590 , 590 , 590 , 590 , 590 , 590 , 590 , 590 , 590 , 590 , 590 , 590 , 590 , 590 , 590 , 590 , 590 , 590 , 590 , 590 , 590 , 590 , 590 , 590 , 590 , 590 , 590 , 590 , 590 , 590 , 590 , 590 , 590 , 590 , 590 , 590 , 590 , 590 , 590 , 590 , 590 , 590 , 590 , 590 , 590 , 
590 , 591 , 592 , 593 , 594 , 570 , 570 , 571 , 572 , 573 , 574 , 575 , 590 , 590 , 590 , 590 , 590 , 590 , 590 , 590 , 590 , 590 , 590 , 590 , 590 , 590 , 590 , 590 , 590 , 590 , 590 , 590 , 590 , 590 , 590 , 590 , 590 , 590 , 590 , 590 , 590 , 590 , 590 , 590 , 590 , 590 , 590 , 590 , 590 , 590 , 590 , 590 , 590 , 590 , 590 , 590 , 590 , 590 , 590 , 590 , 590 , 590 , 590 , 590 , 590 , 590 , 590 , 590 , 590 , 590 , 590 , 590 , 590 , 590 , 590 , 590 , 590 , 590 , 590 , 590 , 590 , 590 , 590 , 590 , 590 , 590 , 590 , 590 , 590 , 590 , 590 , 590 , 590 , 590 , 590 , 590 , 590 , 590 , 590 , 590 , 
590 , 591 , 592 , 593 , 594 , 580 , 580 , 581 , 582 , 583 , 584 , 585 , 590 , 590 , 590 , 590 , 590 , 590 , 590 , 590 , 590 , 590 , 590 , 590 , 590 , 590 , 590 , 590 , 590 , 590 , 590 , 590 , 590 , 590 , 590 , 590 , 590 , 590 , 590 , 590 , 590 , 590 , 590 , 590 , 590 , 590 , 590 , 590 , 590 , 590 , 590 , 590 , 590 , 590 , 590 , 590 , 590 , 590 , 590 , 590 , 590 , 590 , 590 , 590 , 590 , 590 , 590 , 590 , 590 , 590 , 590 , 590 , 590 , 590 , 590 , 590 , 590 , 590 , 590 , 590 , 590 , 590 , 590 , 590 , 590 , 590 , 590 , 590 , 590 , 590 , 590 , 590 , 590 , 590 , 590 , 590 , 590 , 590 , 590 , 590 , 
590 , 591 , 592 , 593 , 594 , 590 , 590 , 591 , 592 , 593 , 594 , 595 , 590 , 590 , 590 , 590 , 590 , 590 , 590 , 590 , 590 , 590 , 590 , 590 , 590 , 590 , 590 , 590 , 590 , 590 , 590 , 590 , 590 , 590 , 590 , 590 , 590 , 590 , 590 , 590 , 590 , 590 , 590 , 590 , 590 , 590 , 590 , 590 , 590 , 590 , 590 , 590 , 590 , 590 , 590 , 590 , 590 , 590 , 590 , 590 , 590 , 590 , 590 , 590 , 590 , 590 , 590 , 590 , 590 , 590 , 590 , 590 , 590 , 590 , 590 , 590 , 590 , 590 , 590 , 590 , 590 , 590 , 590 , 590 , 590 , 590 , 590 , 590 , 590 , 590 , 590 , 590 , 590 , 590 , 590 , 590 , 590 , 590 , 590 , 590 , 
590 , 590 , 590 , 590 , 590 , 590 , 590 , 590 , 590 , 590 , 590 , 590 , 590 , 590 , 590 , 590 , 590 , 590 , 590 , 590 , 590 , 590 , 590 , 590 , 590 , 590 , 590 , 590 , 590 , 590 , 590 , 590 , 590 , 590 , 590 , 590 , 590 , 590 , 590 , 590 , 590 , 590 , 590 , 590 , 590 , 590 , 590 , 590 , 590 , 590 , 590 , 590 , 590 , 590 , 590 , 590 , 590 , 590 , 590 , 590 , 590 , 590 , 590 , 590 , 590 , 590 , 590 , 590 , 590 , 590 , 590 , 590 , 590 , 590 , 590 , 590 , 590 , 590 , 590 , 590 , 590 , 590 , 590 , 590 , 590 , 590 , 590 , 590 , 590 , 590 , 590 , 590 , 590 , 590 , 590 , 590 , 590 , 590 , 590 , 591 , 
600 , 600 , 600 , 600 , 600 , 600 , 600 , 600 , 600 , 600 , 600 , 600 , 600 , 600 , 600 , 600 , 600 , 600 , 600 , 600 , 600 , 600 , 600 , 600 , 600 , 600 , 600 , 600 , 600 , 600 , 600 , 600 , 600 , 600 , 600 , 600 , 600 , 600 , 600 , 600 , 600 , 600 , 600 , 600 , 600 , 600 , 600 , 600 , 600 , 600 , 600 , 600 , 600 , 600 , 600 , 600 , 600 , 600 , 600 , 600 , 600 , 600 , 600 , 600 , 600 , 600 , 600 , 600 , 600 , 600 , 600 , 600 , 600 , 600 , 600 , 600 , 600 , 600 , 600 , 600 , 600 , 600 , 600 , 600 , 600 , 600 , 600 , 600 , 600 , 600 , 600 , 600 , 600 , 600 , 600 , 600 , 600 , 600 , 600 , 601 , 
610 , 610 , 610 , 610 , 610 , 610 , 610 , 610 , 610 , 610 , 610 , 610 , 610 , 610 , 610 , 610 , 610 , 610 , 610 , 610 , 610 , 610 , 610 , 610 , 610 , 610 , 610 , 610 , 610 , 610 , 610 , 610 , 610 , 610 , 610 , 610 , 610 , 610 , 610 , 610 , 610 , 610 , 610 , 610 , 610 , 610 , 610 , 610 , 610 , 610 , 610 , 610 , 610 , 610 , 610 , 610 , 610 , 610 , 610 , 610 , 610 , 610 , 610 , 610 , 610 , 610 , 610 , 610 , 610 , 610 , 610 , 610 , 610 , 610 , 610 , 610 , 610 , 610 , 610 , 610 , 610 , 610 , 610 , 610 , 610 , 610 , 610 , 610 , 610 , 610 , 610 , 610 , 610 , 610 , 610 , 610 , 610 , 610 , 610 , 611 , 
620 , 620 , 620 , 620 , 620 , 620 , 620 , 620 , 620 , 620 , 620 , 620 , 620 , 620 , 620 , 620 , 620 , 620 , 620 , 620 , 620 , 620 , 620 , 620 , 620 , 620 , 620 , 620 , 620 , 620 , 620 , 620 , 620 , 620 , 620 , 620 , 620 , 620 , 620 , 620 , 620 , 620 , 620 , 620 , 620 , 620 , 620 , 620 , 620 , 620 , 620 , 620 , 620 , 620 , 620 , 620 , 620 , 620 , 620 , 620 , 620 , 620 , 620 , 620 , 620 , 620 , 620 , 620 , 620 , 620 , 620 , 620 , 620 , 620 , 620 , 620 , 620 , 620 , 620 , 620 , 620 , 620 , 620 , 620 , 620 , 620 , 620 , 620 , 620 , 620 , 620 , 620 , 620 , 620 , 620 , 620 , 620 , 620 , 620 , 621 , 
630 , 630 , 630 , 630 , 630 , 630 , 630 , 630 , 630 , 630 , 630 , 630 , 630 , 630 , 630 , 630 , 630 , 630 , 630 , 630 , 630 , 630 , 630 , 630 , 630 , 630 , 630 , 630 , 630 , 630 , 630 , 630 , 630 , 630 , 630 , 630 , 630 , 630 , 630 , 630 , 630 , 630 , 630 , 630 , 630 , 630 , 630 , 630 , 630 , 630 , 630 , 630 , 630 , 630 , 630 , 630 , 630 , 630 , 630 , 630 , 630 , 630 , 630 , 630 , 630 , 630 , 630 , 630 , 630 , 630 , 630 , 630 , 630 , 630 , 630 , 630 , 630 , 630 , 630 , 630 , 630 , 630 , 630 , 630 , 630 , 630 , 630 , 630 , 630 , 630 , 630 , 630 , 630 , 630 , 630 , 630 , 630 , 630 , 630 , 631 , 
640 , 640 , 640 , 640 , 640 , 640 , 640 , 640 , 640 , 640 , 640 , 640 , 640 , 640 , 640 , 640 , 640 , 640 , 640 , 640 , 640 , 640 , 640 , 640 , 640 , 640 , 640 , 640 , 640 , 640 , 640 , 640 , 640 , 640 , 640 , 640 , 640 , 640 , 640 , 640 , 640 , 640 , 640 , 640 , 640 , 640 , 640 , 640 , 640 , 640 , 640 , 640 , 640 , 640 , 640 , 640 , 640 , 640 , 640 , 640 , 640 , 640 , 640 , 640 , 640 , 640 , 640 , 640 , 640 , 640 , 640 , 640 , 640 , 640 , 640 , 640 , 640 , 640 , 640 , 640 , 640 , 640 , 640 , 640 , 640 , 640 , 640 , 640 , 640 , 640 , 640 , 640 , 640 , 640 , 640 , 640 , 640 , 640 , 640 , 641 , 
504 , 504 , 504 , 504 , 504 , 504 , 504 , 504 , 504 , 504 , 504 , 504 , 504 , 504 , 504 , 504 , 504 , 504 , 504 , 504 , 504 , 504 , 504 , 504 , 504 , 504 , 504 , 504 , 504 , 504 , 504 , 504 , 504 , 504 , 504 , 504 , 504 , 504 , 504 , 504 , 504 , 504 , 504 , 504 , 504 , 504 , 504 , 504 , 504 , 504 , 504 , 504 , 504 , 504 , 504 , 504 , 504 , 504 , 504 , 504 , 504 , 504 , 504 , 504 , 504 , 504 , 504 , 504 , 504 , 504 , 504 , 504 , 504 , 504 , 504 , 504 , 504 , 504 , 504 , 504 , 504 , 504 , 504 , 504 , 504 , 504 , 504 , 504 , 504 , 504 , 504 , 504 , 504 , 504 , 504 , 504 , 504 , 504 , 504 , 504 , 
514 , 514 , 514 , 514 , 514 , 514 , 514 , 514 , 514 , 514 , 514 , 514 , 514 , 514 , 514 , 514 , 514 , 514 , 514 , 514 , 514 , 514 , 514 , 514 , 514 , 514 , 514 , 514 , 514 , 514 , 514 , 514 , 514 , 514 , 514 , 514 , 514 , 514 , 514 , 514 , 514 , 514 , 514 , 514 , 514 , 514 , 514 , 514 , 514 , 514 , 514 , 514 , 514 , 514 , 514 , 514 , 514 , 514 , 514 , 514 , 514 , 514 , 514 , 514 , 514 , 514 , 514 , 514 , 514 , 514 , 514 , 514 , 514 , 514 , 514 , 514 , 514 , 514 , 514 , 514 , 514 , 514 , 514 , 514 , 514 , 514 , 514 , 514 , 514 , 514 , 514 , 514 , 514 , 514 , 514 , 514 , 514 , 514 , 514 , 514 , 
524 , 524 , 524 , 524 , 524 , 524 , 524 , 524 , 524 , 524 , 524 , 524 , 524 , 524 , 524 , 524 , 524 , 524 , 524 , 524 , 524 , 524 , 524 , 524 , 524 , 524 , 524 , 524 , 524 , 524 , 524 , 524 , 524 , 524 , 524 , 524 , 524 , 524 , 524 , 524 , 524 , 524 , 524 , 524 , 524 , 524 , 524 , 524 , 524 , 524 , 524 , 524 , 524 , 524 , 524 , 524 , 524 , 524 , 524 , 524 , 524 , 524 , 524 , 524 , 524 , 524 , 524 , 524 , 524 , 524 , 524 , 524 , 524 , 524 , 524 , 524 , 524 , 524 , 524 , 524 , 524 , 524 , 524 , 524 , 524 , 524 , 524 , 524 , 524 , 524 , 524 , 524 , 524 , 524 , 524 , 524 , 524 , 524 , 524 , 524 , 
534 , 534 , 534 , 534 , 534 , 534 , 534 , 534 , 534 , 534 , 534 , 534 , 534 , 534 , 534 , 534 , 534 , 534 , 534 , 534 , 534 , 534 , 534 , 534 , 534 , 534 , 534 , 534 , 534 , 534 , 534 , 534 , 534 , 534 , 534 , 534 , 534 , 534 , 534 , 534 , 534 , 534 , 534 , 534 , 534 , 534 , 534 , 534 , 534 , 534 , 534 , 534 , 534 , 534 , 534 , 534 , 534 , 534 , 534 , 534 , 534 , 534 , 534 , 534 , 534 , 534 , 534 , 534 , 534 , 534 , 534 , 534 , 534 , 534 , 534 , 534 , 534 , 534 , 534 , 534 , 534 , 534 , 534 , 534 , 534 , 534 , 534 , 534 , 534 , 534 , 534 , 534 , 534 , 534 , 534 , 534 , 534 , 534 , 534 , 534 , 
544 , 544 , 544 , 544 , 544 , 544 , 544 , 544 , 544 , 544 , 544 , 544 , 544 , 544 , 544 , 544 , 544 , 544 , 544 , 544 , 544 , 544 , 544 , 544 , 544 , 544 , 544 , 544 , 544 , 544 , 544 , 544 , 544 , 544 , 544 , 544 , 544 , 544 , 544 , 544 , 544 , 544 , 544 , 544 , 544 , 544 , 544 , 544 , 544 , 544 , 544 , 544 , 544 , 544 , 544 , 544 , 544 , 544 , 544 , 544 , 544 , 544 , 544 , 544 , 544 , 544 , 544 , 544 , 544 , 544 , 544 , 544 , 544 , 544 , 544 , 544 , 544 , 544 , 544 , 544 , 544 , 544 , 544 , 544 , 544 , 544 , 544 , 544 , 544 , 544 , 544 , 544 , 544 , 544 , 544 , 544 , 544 , 544 , 544 , 544 , 
