566 , 566 , 566 , 566 , 566 , 566 , 566 , 566 , 566 , 566 , 566 , 566 , 566 , 566 , 566 , 566 , 566 , 566 , 566 , 566 , 566 , 566 , 566 , 566 , 566 , 566 , 566 , 566 , 566 , 566 , 566 , 566 , 566 , 566 , 566 , 566 , 566 , 566 , 566 , 566 , 566 , 566 , 566 , 566 , 566 , 566 , 566 , 566 , 566 , 566 , 566 , 566 , 566 , 566 , 566 , 566 , 566 , 566 , 566 , 566 , 566 , 566 , 566 , 566 , 566 , 566 , 566 , 566 , 566 , 566 , 566 , 566 , 566 , 566 , 566 , 566 , 566 , 566 , 566 , 566 , 566 , 566 , 566 , 566 , 566 , 566 , 566 , 566 , 566 , 566 , 566 , 566 , 566 , 566 , 566 , 566 , 566 , 566 , 566 , 566 , 
576 , 576 , 576 , 576 , 576 , 576 , 576 , 576 , 576 , 576 , 576 , 576 , 576 , 576 , 576 , 576 , 576 , 576 , 576 , 576 , 576 , 576 , 576 , 576 , 576 , 576 , 576 , 576 , 576 , 576 , 576 , 576 , 576 , 576 , 576 , 576 , 576 , 576 , 576 , 576 , 576 , 576 , 576 , 576 , 576 , 576 , 576 , 576 , 576 , 576 , 576 , 576 , 576 , 576 , 576 , 576 , 576 , 576 , 576 , 576 , 576 , 576 , 576 , 576 , 576 , 576 , 576 , 576 , 576 , 576 , 576 , 576 , 576 , 576 , 576 , 576 , 576 , 576 , 576 , 576 , 576 , 576 , 576 , 576 , 576 , 576 , 576 , 576 , 576 , 576 , 576 , 576 , 576 , 576 , 576 , 576 , 576 , 576 , 576 , 576 , 
586 , 586 , 586 , 586 , 586 , 586 , 586 , 586 , 586 , 586 , 586 , 586 , 586 , 586 , 586 , 586 , 586 , 586 , 586 , 586 , 586 , 586 , 586 , 586 , 586 , 586 , 586 , 586 , 586 , 586 , 586 , 586 , 586 , 586 , 586 , 586 , 586 , 586 , 586 , 586 , 586 , 586 , 586 , 586 , 586 , 586 , 586 , 586 , 586 , 586 , 586 , 586 , 586 , 586 , 586 , 586 , 586 , 586 , 586 , 586 , 586 , 586 , 586 , 586 , 586 , 586 , 586 , 586 , 586 , 586 , 586 , 586 , 586 , 586 , 586 , 586 , 586 , 586 , 586 , 586 , 586 , 586 , 586 , 586 , 586 , 586 , 586 , 586 , 586 , 586 , 586 , 586 , 586 , 586 , 586 , 586 , 586 , 586 , 586 , 586 , 
596 , 596 , 596 , 596 , 596 , 596 , 596 , 596 , 596 , 596 , 596 , 596 , 596 , 596 , 596 , 596 , 596 , 596 , 596 , 596 , 596 , 596 , 596 , 596 , 596 , 596 , 596 , 596 , 596 , 596 , 596 , 596 , 596 , 596 , 596 , 596 , 596 , 596 , 596 , 596 , 596 , 596 , 596 , 596 , 596 , 596 , 596 , 596 , 596 , 596 , 596 , 596 , 596 , 596 , 596 , 596 , 596 , 596 , 596 , 596 , 596 , 596 , 596 , 596 , 596 , 596 , 596 , 596 , 596 , 596 , 596 , 596 , 596 , 596 , 596 , 596 , 596 , 596 , 596 , 596 , 596 , 596 , 596 , 596 , 596 , 596 , 596 , 596 , 596 , 596 , 596 , 596 , 596 , 596 , 596 , 596 , 596 , 596 , 596 , 596 , 
606 , 606 , 606 , 606 , 606 , 606 , 606 , 606 , 606 , 606 , 606 , 606 , 606 , 606 , 606 , 606 , 606 , 606 , 606 , 606 , 606 , 606 , 606 , 606 , 606 , 606 , 606 , 606 , 606 , 606 , 606 , 606 , 606 , 606 , 606 , 606 , 606 , 606 , 606 , 606 , 606 , 606 , 606 , 606 , 606 , 606 , 606 , 606 , 606 , 606 , 606 , 606 , 606 , 606 , 606 , 606 , 606 , 606 , 606 , 606 , 606 , 606 , 606 , 606 , 606 , 606 , 606 , 606 , 606 , 606 , 606 , 606 , 606 , 606 , 606 , 606 , 606 , 606 , 606 , 606 , 606 , 606 , 606 , 606 , 606 , 606 , 606 , 606 , 606 , 606 , 606 , 606 , 606 , 606 , 606 , 606 , 606 , 606 , 606 , 606 , 
616 , 616 , 616 , 616 , 616 , 616 , 616 , 616 , 616 , 616 , 616 , 616 , 616 , 616 , 616 , 616 , 616 , 616 , 616 , 616 , 616 , 616 , 616 , 616 , 616 , 616 , 616 , 616 , 616 , 616 , 616 , 616 , 616 , 616 , 616 , 616 , 616 , 616 , 616 , 616 , 616 , 616 , 616 , 616 , 616 , 616 , 616 , 616 , 616 , 616 , 616 , 616 , 616 , 616 , 616 , 616 , 616 , 616 , 616 , 616 , 616 , 616 , 616 , 616 , 616 , 616 , 616 , 616 , 616 , 616 , 616 , 616 , 616 , 616 , 616 , 616 , 616 , 616 , 616 , 616 , 616 , 616 , 616 , 616 , 616 , 616 , 616 , 616 , 616 , 616 , 616 , 616 , 616 , 616 , 616 , 616 , 616 , 616 , 616 , 616 , 
626 , 626 , 626 , 626 , 626 , 626 , 626 , 626 , 626 , 626 , 626 , 626 , 626 , 626 , 626 , 626 , 626 , 626 , 626 , 626 , 626 , 626 , 626 , 626 , 626 , 626 , 626 , 626 , 626 , 626 , 626 , 626 , 626 , 626 , 626 , 626 , 626 , 626 , 626 , 626 , 626 , 626 , 626 , 626 , 626 , 626 , 626 , 626 , 626 , 626 , 626 , 626 , 626 , 626 , 626 , 626 , 626 , 626 , 626 , 626 , 626 , 626 , 626 , 626 , 626 , 626 , 626 , 626 , 626 , 626 , 626 , 626 , 626 , 626 , 626 , 626 , 626 , 626 , 626 , 626 , 626 , 626 , 626 , 626 , 626 , 626 , 626 , 626 , 626 , 626 , 626 , 626 , 626 , 626 , 626 , 626 , 626 , 626 , 626 , 626 , 
636 , 636 , 636 , 636 , 636 , 636 , 636 , 636 , 636 , 636 , 636 , 636 , 636 , 636 , 636 , 636 , 636 , 636 , 636 , 636 , 636 , 636 , 636 , 636 , 636 , 636 , 636 , 636 , 636 , 636 , 636 , 636 , 636 , 636 , 636 , 636 , 636 , 636 , 636 , 636 , 636 , 636 , 636 , 636 , 636 , 636 , 636 , 636 , 636 , 636 , 636 , 636 , 636 , 636 , 636 , 636 , 636 , 636 , 636 , 636 , 636 , 636 , 636 , 636 , 636 , 636 , 636 , 636 , 636 , 636 , 636 , 636 , 636 , 636 , 636 , 636 , 636 , 636 , 636 , 636 , 636 , 636 , 636 , 636 , 636 , 636 , 636 , 636 , 636 , 636 , 636 , 636 , 636 , 636 , 636 , 636 , 636 , 636 , 636 , 636 , 
630 , 630 , 630 , 630 , 630 , 630 , 630 , 630 , 630 , 630 , 630 , 630 , 630 , 630 , 630 , 630 , 630 , 630 , 630 , 630 , 630 , 630 , 630 , 630 , 630 , 630 , 630 , 630 , 630 , 630 , 630 , 630 , 630 , 630 , 630 , 630 , 630 , 630 , 630 , 630 , 630 , 630 , 630 , 630 , 630 , 630 , 630 , 630 , 630 , 630 , 630 , 630 , 630 , 630 , 630 , 630 , 630 , 630 , 630 , 630 , 630 , 630 , 630 , 630 , 630 , 630 , 630 , 630 , 630 , 630 , 630 , 630 , 630 , 630 , 630 , 630 , 630 , 630 , 630 , 630 , 630 , 630 , 630 , 630 , 630 , 630 , 630 , 630 , 630 , 630 , 630 , 630 , 630 , 630 , 630 , 631 , 632 , 633 , 634 , 635 , 
635 , 636 , 636 , 636 , 636 , 636 , 636 , 636 , 636 , 636 , 636 , 636 , 636 , 636 , 636 , 636 , 636 , 636 , 636 , 636 , 636 , 636 , 636 , 636 , 636 , 636 , 636 , 636 , 636 , 636 , 636 , 636 , 636 , 636 , 636 , 636 , 636 , 636 , 636 , 636 , 636 , 636 , 636 , 636 , 636 , 636 , 636 , 636 , 636 , 636 , 636 , 636 , 636 , 636 , 636 , 636 , 636 , 636 , 636 , 636 , 636 , 636 , 636 , 636 , 636 , 636 , 636 , 636 , 636 , 636 , 636 , 636 , 636 , 636 , 636 , 636 , 636 , 636 , 636 , 636 , 636 , 636 , 636 , 636 , 636 , 636 , 636 , 636 , 636 , 636 , 636 , 636 , 636 , 636 , 636 , 636 , 636 , 636 , 636 , 636 , 
630 , 630 , 630 , 630 , 630 , 630 , 630 , 630 , 630 , 630 , 630 , 630 , 630 , 630 , 630 , 630 , 630 , 630 , 630 , 630 , 630 , 630 , 630 , 630 , 630 , 630 , 630 , 630 , 630 , 630 , 630 , 630 , 630 , 630 , 630 , 630 , 630 , 630 , 630 , 630 , 630 , 630 , 630 , 630 , 630 , 630 , 630 , 630 , 630 , 630 , 630 , 630 , 630 , 630 , 630 , 630 , 630 , 630 , 630 , 630 , 630 , 630 , 630 , 630 , 630 , 630 , 630 , 630 , 630 , 630 , 630 , 630 , 630 , 630 , 630 , 630 , 630 , 630 , 630 , 630 , 630 , 630 , 630 , 630 , 630 , 630 , 630 , 630 , 630 , 630 , 630 , 630 , 630 , 630 , 630 , 630 , 630 , 630 , 630 , 630 , 
-1 , -1 , -1 , -1 , -1 , -1 , -1 , -1 , -1 , -1 , -1 , -1 , -1 , -1 , -1 , -1 , -1 , -1 , -1 , -1 , -1 , -1 , -1 , -1 , -1 , -1 , -1 , -1 , -1 , -1 , -1 , -1 , -1 , -1 , -1 , -1 , -1 , -1 , -1 , -1 , -1 , -1 , -1 , -1 , -1 , -1 , -1 , -1 , -1 , -1 , -1 , -1 , -1 , -1 , -1 , -1 , -1 , -1 , -1 , -1 , -1 , -1 , -1 , -1 , -1 , -1 , -1 , -1 , -1 , -1 , -1 , -1 , -1 , -1 , -1 , -1 , -1 , -1 , -1 , -1 , -1 , -1 , -1 , -1 , -1 , -1 , -1 , -1 , -1 , -1 , -1 , -1 , -1 , -1 , -1 , -1 , -1 , -1 , -1 , -1 , 
-1 , -1 , -1 , -1 , -1 , -1 , -1 , -1 , -1 , -1 , -1 , -1 , -1 , -1 , -1 , -1 , -1 , -1 , -1 , -1 , -1 , -1 , -1 , -1 , -1 , -1 , -1 , -1 , -1 , -1 , -1 , -1 , -1 , -1 , -1 , -1 , -1 , -1 , -1 , -1 , -1 , -1 , -1 , -1 , -1 , -1 , -1 , -1 , -1 , -1 , -1 , -1 , -1 , -1 , -1 , -1 , -1 , -1 , -1 , -1 , -1 , -1 , -1 , -1 , -1 , -1 , -1 , -1 , -1 , -1 , -1 , -1 , -1 , -1 , -1 , -1 , -1 , -1 , -1 , -1 , -1 , -1 , -1 , -1 , -1 , -1 , -1 , -1 , -1 , -1 , -1 , -1 , -1 , -1 , -1 , -1 , -1 , -1 , -1 , -1 , 
-1 , -1 , -1 , -1 , -1 , -1 , -1 , -1 , -1 , -1 , -1 , -1 , -1 , -1 , -1 , -1 , -1 , -1 , -1 , -1 , -1 , -1 , -1 , -1 , -1 , -1 , -1 , -1 , -1 , -1 , -1 , -1 , -1 , -1 , -1 , -1 , -1 , -1 , -1 , -1 , -1 , -1 , -1 , -1 , -1 , -1 , -1 , -1 , -1 , -1 , -1 , -1 , -1 , -1 , -1 , -1 , -1 , -1 , -1 , -1 , -1 , -1 , -1 , -1 , -1 , -1 , -1 , -1 , -1 , -1 , -1 , -1 , -1 , -1 , -1 , -1 , -1 , -1 , -1 , -1 , -1 , -1 , -1 , -1 , -1 , -1 , -1 , -1 , -1 , -1 , -1 , -1 , -1 , -1 , -1 , -1 , -1 , -1 , -1 , -1 , 
-1 , -1 , -1 , -1 , -1 , -1 , -1 , -1 , -1 , -1 , -1 , -1 , -1 , -1 , -1 , -1 , -1 , -1 , -1 , -1 , -1 , -1 , -1 , -1 , -1 , -1 , -1 , -1 , -1 , -1 , -1 , -1 , -1 , -1 , -1 , -1 , -1 , -1 , -1 , -1 , -1 , -1 , -1 , -1 , -1 , -1 , -1 , -1 , -1 , -1 , -1 , -1 , -1 , -1 , -1 , -1 , -1 , -1 , -1 , -1 , -1 , -1 , -1 , -1 , -1 , -1 , -1 , -1 , -1 , -1 , -1 , -1 , -1 , -1 , -1 , -1 , -1 , -1 , -1 , -1 , -1 , -1 , -1 , -1 , -1 , -1 , -1 , -1 , -1 , -1 , -1 , -1 , -1 , -1 , -1 , -1 , -1 , -1 , -1 , -1 , 
-1 , -1 , -1 , -1 , -1 , -1 , -1 , -1 , -1 , -1 , -1 , -1 , -1 , -1 , -1 , -1 , -1 , -1 , -1 , -1 , -1 , -1 , -1 , -1 , -1 , -1 , -1 , -1 , -1 , -1 , -1 , -1 , -1 , -1 , -1 , -1 , -1 , -1 , -1 , -1 , -1 , -1 , -1 , -1 , -1 , -1 , -1 , -1 , -1 , -1 , -1 , -1 , -1 , -1 , -1 , -1 , -1 , -1 , -1 , -1 , -1 , -1 , -1 , -1 , -1 , -1 , -1 , -1 , -1 , -1 , -1 , -1 , -1 , -1 , -1 , -1 , -1 , -1 , -1 , -1 , -1 , -1 , -1 , -1 , -1 , -1 , -1 , -1 , -1 , -1 , -1 , -1 , -1 , -1 , -1 , -1 , -1 , -1 , -1 , -1 , 
504 , 504 , 504 , 504 , 504 , 504 , 504 , 504 , 504 , 504 , 504 , 504 , 504 , 504 , 504 , 504 , 504 , 504 , 504 , 504 , 504 , 504 , 504 , 504 , 504 , 504 , 504 , 504 , 504 , 504 , 504 , 504 , 504 , 504 , 504 , 504 , 504 , 504 , 504 , 504 , 504 , 504 , 504 , 504 , 504 , 504 , 504 , 504 , 504 , 504 , 504 , 504 , 504 , 504 , 504 , 504 , 504 , 504 , 504 , 504 , 504 , 504 , 504 , 504 , 504 , 504 , 504 , 504 , 504 , 504 , 504 , 504 , 504 , 504 , 504 , 504 , 504 , 504 , 504 , 504 , 504 , 504 , 504 , 504 , 504 , 504 , 504 , 504 , 504 , 504 , 504 , 504 , 504 , 504 , 504 , 504 , 504 , 504 , 504 , 504 , 
514 , 514 , 514 , 514 , 514 , 514 , 514 , 514 , 514 , 514 , 514 , 514 , 514 , 514 , 514 , 514 , 514 , 514 , 514 , 514 , 514 , 514 , 514 , 514 , 514 , 514 , 514 , 514 , 514 , 514 , 514 , 514 , 514 , 514 , 514 , 514 , 514 , 514 , 514 , 514 , 514 , 514 , 514 , 514 , 514 , 514 , 514 , 514 , 514 , 514 , 514 , 514 , 514 , 514 , 514 , 514 , 514 , 514 , 514 , 514 , 514 , 514 , 514 , 514 , 514 , 514 , 514 , 514 , 514 , 514 , 514 , 514 , 514 , 514 , 514 , 514 , 514 , 514 , 514 , 514 , 514 , 514 , 514 , 514 , 514 , 514 , 514 , 514 , 514 , 514 , 514 , 514 , 514 , 514 , 514 , 514 , 514 , 514 , 514 , 514 , 
524 , 524 , 524 , 524 , 524 , 524 , 524 , 524 , 524 , 524 , 524 , 524 , 524 , 524 , 524 , 524 , 524 , 524 , 524 , 524 , 524 , 524 , 524 , 524 , 524 , 524 , 524 , 524 , 524 , 524 , 524 , 524 , 524 , 524 , 524 , 524 , 524 , 524 , 524 , 524 , 524 , 524 , 524 , 524 , 524 , 524 , 524 , 524 , 524 , 524 , 524 , 524 , 524 , 524 , 524 , 524 , 524 , 524 , 524 , 524 , 524 , 524 , 524 , 524 , 524 , 524 , 524 , 524 , 524 , 524 , 524 , 524 , 524 , 524 , 524 , 524 , 524 , 524 , 524 , 524 , 524 , 524 , 524 , 524 , 524 , 524 , 524 , 524 , 524 , 524 , 524 , 524 , 524 , 524 , 524 , 524 , 524 , 524 , 524 , 524 , 
534 , 534 , 534 , 534 , 534 , 534 , 534 , 534 , 534 , 534 , 534 , 534 , 534 , 534 , 534 , 534 , 534 , 534 , 534 , 534 , 534 , 534 , 534 , 534 , 534 , 534 , 534 , 534 , 534 , 534 , 534 , 534 , 534 , 534 , 534 , 534 , 534 , 534 , 534 , 534 , 534 , 534 , 534 , 534 , 534 , 534 , 534 , 534 , 534 , 534 , 534 , 534 , 534 , 534 , 534 , 534 , 534 , 534 , 534 , 534 , 534 , 534 , 534 , 534 , 534 , 534 , 534 , 534 , 534 , 534 , 534 , 534 , 534 , 534 , 534 , 534 , 534 , 534 , 534 , 534 , 534 , 534 , 534 , 534 , 534 , 534 , 534 , 534 , 534 , 534 , 534 , 534 , 534 , 534 , 534 , 534 , 534 , 534 , 534 , 534 , 
544 , 544 , 544 , 544 , 544 , 544 , 544 , 544 , 544 , 544 , 544 , 544 , 544 , 544 , 544 , 544 , 544 , 544 , 544 , 544 , 544 , 544 , 544 , 544 , 544 , 544 , 544 , 544 , 544 , 544 , 544 , 544 , 544 , 544 , 544 , 544 , 544 , 544 , 544 , 544 , 544 , 544 , 544 , 544 , 544 , 544 , 544 , 544 , 544 , 544 , 544 , 544 , 544 , 544 , 544 , 544 , 544 , 544 , 544 , 544 , 544 , 544 , 544 , 544 , 544 , 544 , 544 , 544 , 544 , 544 , 544 , 544 , 544 , 544 , 544 , 544 , 544 , 544 , 544 , 544 , 544 , 544 , 544 , 544 , 544 , 544 , 544 , 544 , 544 , 544 , 544 , 544 , 544 , 544 , 544 , 544 , 544 , 544 , 544 , 544 , 
554 , 554 , 554 , 554 , 554 , 554 , 554 , 554 , 554 , 554 , 554 , 554 , 554 , 554 , 554 , 554 , 554 , 554 , 554 , 554 , 554 , 554 , 554 , 554 , 554 , 554 , 554 , 554 , 554 , 554 , 554 , 554 , 554 , 554 , 554 , 554 , 554 , 554 , 554 , 554 , 554 , 554 , 554 , 554 , 554 , 554 , 554 , 554 , 554 , 554 , 554 , 554 , 554 , 554 , 554 , 554 , 554 , 554 , 554 , 554 , 554 , 554 , 554 , 554 , 554 , 554 , 554 , 554 , 554 , 554 , 554 , 554 , 554 , 554 , 554 , 554 , 554 , 554 , 554 , 554 , 554 , 554 , 554 , 554 , 554 , 554 , 554 , 554 , 554 , 554 , 554 , 554 , 554 , 554 , 554 , 554 , 554 , 554 , 554 , 554 , 
